2019-12-26T13:30:05.011196
Championnat du Chili de football 1977 => Chili => Espagnol => Langues romanes => Latin vulgaire => Latin
La Fleur et le Flagada => Charles Degotte => Verviers => Wallon => Langue d'oïl => Langues romanes
Jean-Paul Snappe => Frameries => Commune (Belgique) => Organisation territoriale de la Belgique => Article premier de la Constitution belge => Fédéralisme => Comores (pays) => Comorien => Variété (linguistique) => Sociolinguistique => Sociologie => Discipline (spécialité) => Savoir => Connaissance
HSPD-12 => George W. Bush => New Haven => États des États-Unis => République => Démocratie => Grec ancien => Grec => Grec moderne => Langue => Système => Ensemble => Mathématiques => Connaissance => Notion => Connaissance (philosophie) => Philosophie
Sentieri selvaggi => Ensemble musical => Musicien => Jeu (musique) => Musique => Art => Sens (physiologie) => Physiologie => Organisme (physiologie) => Grec
Sonia LeBel => 1968 => Année bissextile commençant un lundi => Année (calendrier) => Temps => Notion
Teratoscincus toksunicus => Espèce => Biologie
Duško Pijetlović => Novi Sad => Serbe => Alphabet cyrillique serbe => Vuk Stefanović Karadžić => Alphabet cyrillique serbe
O'Hare => Larry Hama => 7 juin => Jour => Temps
Diocèse de Digne, Riez et Sisteron => Latin
District de Magoé => Province de Tete => Portugais => Langue
Langnau => Commune (Suisse) => Suisse => Allemand => Langues indo-européennes => Linguistique => Discipline scientifique => Science formelle => Déduction => Logique => Grec ancien
Coupe Spengler 1959 => Coupe Spengler => Hockey sur glace => Sport collectif => Sport
Chârost => Commune (France)
Renémesnil => Commune (France) => France => 1875 => 15 février => Jour
Altmann de Passau => Westphalie => Allemand
Mascarade des Makishi => Circoncision => Latin
Pauline Donalda => Canada => Anglais => Langue
Emil Abossolo-Mbo => Cameroun => Anglais
Volvulus => Médecine => Latin
10e étape du Tour d'Espagne 1999 => 15 septembre => Jour
Hédi Ben Ouezdou => Arabe => Langues chamito-sémitiques => Famille de langues => Langue
District de Saint-Léonard => District (subdivision départementale) => Département français => Organisation territoriale de la France => Collectivité territoriale en France => France
Maitland => Vallée Hunter => Nouvelle-Galles du Sud => Anglais
Dave Lebling => Concepteur de jeu => Années 1990 => Guerres de Yougoslavie => République fédérative socialiste de Yougoslavie => Yougoslavie => Serbo-croate => Yougoslavie
Jay Howard => Basildon => Royaume-Uni => Anglais
Andrew Robertson (athlétisme) => Grantham => Midlands de l'Est => Angleterre => Anglais
Taurus de Béryte => Béryte => Grec ancien
Simon Wood => 1968
TrackMania Turbo (jeu vidéo, 2016) => Jeu vidéo => Jeu électronique => Jeu => Psychisme => Conscience => Concept (philosophie) => Proposition (philosophie) => Philosophie
